1111111001111111
1111110000111111
1111100000011111
1111000000001111
1110000000000111
0000000110000000
0000000110000000
1110000000000111
1111000000001111
1111100000011111
1111110000111111
1111111001111111