0000000000000000
0000000000000000
000000YW00000000
00000Y000000W000
0000W0Y000000000
0000000000000000
00Y0000000000000
00000000000W0000
0000Y00000000000
0000000W00000000
0000000000000000
0000000000000000
