0000000000000000
0000000000000000
0000000X0Y0X0000
000000Y000000000
0000000000000000
0000000000X00000
0000000000000000
00Y0000000000X00
000Y000000000Y00
0000000000000W00
0000000000000000
0000000000000000
