0000000000000000
0000000000000000
0000000000000000
0000000000Y00Y00
000000Y000000000
0000000000000000
0000000000W00000
0000000Y00Y00000
00000000W0000W00
0000Y00Y00000000
0000000000000000
0000000000000000
