0000000000000000
0000000000000000
00Y00Y0000000000
000YW00000000000
0000000000000000
0000000Y0Y000000
00Y0YY00W0000000
0000000000000000
00Y00W000X0W0000
0000000000X00000
0000000000000000
0000000000000000
