1111111001111111
1000000000000001
1000000000000001
1000000000000001
1000000000000001
0000000000000000
0000000000000000
1000000000000001
1000000000000001
1000000000000001
1000000000000001
1111111001111111