1111111001111111
1000000000000001
1000000110000001
1000000000000001
1000000110000001
0010001111000100
0010001111000100
1000000110000001
1000000000000001
1000000110000001
1000000000000001
1111111111111111
