1111111001111111
1000001000000001
1000001111100001
1000000000000001
1001110000000111
1001000000000100
1001000000000100
1111000000000101
1000000000000101
1000011111100001
1000000001110001
1111111001111111
