1111111001111111
1000000001000001
1011111111000001
1000000000000001
1111111111111101
0000000000000000
0000000000000000
1000000010000001
1000000101000001
1000000010000001
1000000000000001
1111111001111111