0000000000000000
0000000000000000
0000X00000000W00
00XXX00Y0000X000
0000000Y00000000
000WW00000000W00
0000000X00Y00000
000000X000000000
0000000000000W00
00Y00000000Y0000
0000000000000000
0000000000000000
