0000000000000000
0000000000000000
0000000000000000
000000WY00000000
00000000X0000000
00Y0000000000000
000Y00W00W0Y0000
000000W000000000
000000000W0W0000
000000000X000000
0000000000000000
0000000000000000
