0000000000000000
0000000000000000
00000Y000Y000000
000000000000Y000
00000Y0000Y00000
0000000000000000
00000Y0000000000
000000000000X000
00X000Y0000YW000
000000000Y000000
0000000000000000
0000000000000000
