0000000000000000
0000000000000000
0000X0000YY00000
0000000Y00000000
0000000000000000
000WY0X000000000
00X0000000000000
0000000YY0000000
000X000000000000
0000000000000000
0000000000000000
0000000000000000
