0000000000000000
0000000000000000
000000Y000000W00
000000000YW00000
00000X0000000000
0000000000Y00000
0000X00000000000
000000000X000000
00000W0000000000
000000000000W000
0000000000000000
0000000000000000
