0000000000000000
0000000000000000
0000000000000000
0000000000000000
0000W0000Y000000
000000Y000000000
000WYY0000000000
00000X0000WX0000
000000YY00000000
0000000000000000
0000000000000000
0000000000000000
