0000000000000000
0000000000000000
0000000000000000
000000000Y00W000
0000000000000000
00000X0WY0000000
000000W000X00000
000000Y00000W000
000000000000W000
0000000000000000
0000000000000000
0000000000000000
