0000000000000000
0000000000000000
000000Y000000000
0000000000000000
0000000000Y0Y000
0000Y00000000000
000W000000000000
00000X0000000000
0000000Y00000000
0000Y0W000Y00000
0000000000000000
0000000000000000
