0000000000000000
0000000000000000
00W0000000Y00000
0000000000000000
0000YY00000Y0000
00000000000W0000
000000000000Y000
0000000000000000
00W00000000W0000
00WX00000000X000
0000000000000000
0000000000000000
