0000000000000000
0000000000000000
000XW000000Y0Y00
000000W0X000X000
0000000000000000
0000000000000000
0000000000W00000
0000000X00000000
0000000000000W00
0000000000000000
0000000000000000
0000000000000000
