0000000000000000
0000000000000000
000Y000Y00000000
00000X00W0000000
0000000000000000
000000W000000000
000W000W00Y00000
00000000X0000000
0000000000000W00
0000000000000000
0000000000000000
0000000000000000
