1111111001111111
1000000000000001
1000000001000001
1000000010000001
1000000100000001
1000001000000000
1000010000000000
1000100000000101
1001000000001001
1010000000010001
1100000000100001
1111111001111111
