1111111001111111
1000000000000001
1000000000001001
1001000001000001
1000001000000001
0010000010000000
0000000010000000
1000100000000101
1000000000000001
1000100010000001
1010000000000101
1111111001111111
