1111111001111111
1000000000000001
1000001111000001
1000000000000001
1111110000111111
0000000000000001
0000000000000001
1111110000111111
1000000000000001
1000001111000001
1000000000000001
1111111001111111
