1111111001111111
1111000000001111
1100000000000011
1100000000000011
1000000110000001
1000001111000000
1000001111000000
1000000110000001
1100000000000011
1100000000000011
1111000000001111
1111111001111111
