1111111111111111
1110000000000011
1100000000000001
1000000000110001
1000000000111111
1000000000010000
1000100000000000
1111110000000001
1000110000000001
1000000000000011
1100000000000111
1111111001111111
