1111111001111111
1000000000000001
1000000110000001
1000000000000001
1000000110000001
0010001111000101
0010001111000101
1000000110000001
1000000000000001
1000000110000001
1000000000000001
1111111001111111
