1111111001111111
1110000000000011
1100000000000001
1000000000110001
1000000000111111
0000000000010000
0000100000000000
1111110000000001
1000110000000001
1000000000000011
1100000000000111
1111111111111111
