1111111001111111
1111111001111111
1011111001111101
1001111001111001
1000111001110001
0000011001100000
0000000000000000
1000000000000001
1100000000000011
1110000000000111
1111000000001111
1111111001111111
