1111111111111111
1010001000000001
1000100000001001
1000001000010011
1000000100010001
0001010000100000
0000001000000000
1001001001001001
1010000000100001
1010000010001001
1001000000001001
1111111001111111
