1111111001111111
1000000000000001
1000000000000001
1000000100001001
1000000010001001
0000000001001000
0000000000101000
1000000000011001
1000000111111001
1000000000000001
1000000000000021
1111111001111111